#-------------#
--------------#
#--------#-*-##
##----------###
###--------####
####------++###
#####----##+###
######--###++##
######-#####+##
#####---####+##
####-----##++##
###-------#+###
##---#-----+###
#--------oo-###
---------oo--##
